msv: nlh
lsd: mfs fpv nlc jjg bbb gmv
lbf: dxk
jlf: rdb rvx rcl bqc
fjk: hfb
tll: rqx pms
bbk: bst zfs dpb dlq
klb: ktc nzs xsk hbp
rvm: jfd skf gkv
hrq: rmk pmb pts pdf
vtx: fvh pnn
ttt: gdf scv xrz
fzd: vdk qsz dnf
bqm: cxr nvk jfd cgl
qgn: dbz lrp
jrk: htq nsq klc
pkn: njn fcs xrz
xsk: gfc tpm
ttg: bdd mkx dxc kdz
nxg: gbq fqt
mhg: cfg hdr znv rfn
fzg: jkg qhx rfl vhp
lnj: vnc mdj
pms: mdj nfj
dmb: mqv
bkr: lzd hdz fdv mzq
brq: bmc pls nsv
bqf: zkf
xzd: jgs bdd vll qrb
jqj: rhx dxh lvk tvv
ghd: std vzs
lzh: pgt
gzd: xzb fdr zbp zjp
gqp: hch bfb fjv hjx bxd
vkc: kdt
hfq: gkj qmt
dms: dsx pgm xpq qgn vfn
zxd: kjf thq rcj zmt jht
dnk: tqx hsl
grd: rrv mdv fcp
rzd: rcj kjr kpq hjk
qrn: dbl jpm msn
sph: xxk rkh jkg sff qfb
kfm: tgt
qzq: jbg
jlz: zxj xvq znq
pnd: pzh xgr rcl
ttq: tql fcp vcp qhm
vnk: vfd qcp
nrq: xcq tql tvc
htq: rbm qhx tkt
hlj: ndl lkx nbp bxz
sxc: ffz bfm vgh bsg kls jcf
pjv: vll sjp hzm
jlj: bcm
ndh: dpz plz jvl srv
hnb: zkx jsm
rvs: jhm
fkg: rzx
hsx: rcx
hqt: lkq fgc
qbb: tsh dnj bjm
hdr: tgt cfl
gtr: fpt
mch: rgx xck
mqh: fzc jrt
kmr: pzd
xqq: hzz knm fdd zmj
lxp: nrg nnf dnv fms
ckp: svb cjn vqj
ltb: bsp
hcz: pzd ljc rvm bvj
zkx: xtj qvb
lzg: xzq fnx
njz: ztf
xvx: fpt xqn xhn qfc
nxf: rfn nqn fkg ddk
gpz: bcr czd zpm zjd
fdc: xlk ghq tvg
plz: rhc dds dtx
xjc: vtj bsq rkh
zrf: hzz
ncn: gtr
pts: ftn
zlx: mxx rcb
qxx: vrc zst npk
rhc: dqc
kds: vcg bjm cxr rkg
sds: vpz dcv zbq ckq bqd
vjm: gbq kqk
dfp: vjm tpm kdv khl gkr
nbz: zft dxk
psg: vdr rpv
kjf: xnq
hzk: qfc vbt
mnr: nhf skk zxt rmg
drk: qlp xbv
sdv: pnl zlh dhd
xxk: fzb tql jpj
std: hvb bsg
ndv: sld gdl
pgk: csd nxt cjd xlk
vsf: jgd kfm trf
qtk: rhl
fvg: tgl vcb mjb hpz
htz: shx hvc spq fvj jcf nnk hmb
tvc: lzd thq lht jzd nct
bdg: lfx
jkg: mtj gsl ktf
kpc: rcc crj
mgs: svb tpt
dgb: qvg
nbc: bnx jpt pgt
ngj: gnl zkx lvz rgg
czp: lbs
sqk: hbc dmb tnx mfs
sdt: jrt xvr
kdv: fsj qbh msj
hpv: xxb jsm
trf: jbn
fpn: bfm
nnv: ghl dbl jds bhq
zlh: vxp
xjt: bgj mhs pzd lxb hqk
pbg: qzq pls zmb rxx rfs ckf
dsx: nlb bbr xzq
rhn: cxr vjl
qlh: cpb jgl tvd bdq
fhp: jpv dbk
hrf: tdv rvp vfd trk
xzb: ksj
gdt: qnh rvp klf
chb: hfc fdr tkt
jsq: qrr czg kft
fjr: xnd
kjp: gqd
vdb: mgx
vrn: cvk
rkh: mhs rhc gnb
fvc: pbj fht fdd lbs gxg
cnr: rhl xjf
vhp: kgf jht glq
kqr: fpt scv rpr lzg
pzj: frr dps
lxj: qsq hcm ngn xng shr
jgh: xvq jcc rnt khl
rvc: tzm vcp lgl
cct: vnc pfc sjn fkb kpc hfb
nvv: gfv ntb
dqb: czh
nvk: cts ccz
zmt: rbm bcx znm xtx
xbr: pmk xqt nrk zcn dlk xll
mcx: bdm jsm cst
mgt: lrd knm dzf
zgc: lbs qlp ksj
zpm: mgx qmv
qhf: zcp nhf vgh fsb
cfl: pvk mrg pkd cnr
spq: mmt mhb dqb
btt: kpf
kzd: lrk dqh scd vdb
lkq: gbr
nkl: hmm trf kvx kpc
lqg: mxq zgc bmr fsn klp qgp
tvj: gdl tgs dlb
rnq: pkd sjm jfv ndl
rcm: vcb gqn cns
nsp: crj cjd dbq
tmh: fjk ndt pct njj
xxm: mlp lbf
gmm: gfm rqz dpk pjx kqt
txb: sxn hvc
rvj: sxf dqh xxm gxp
gnl: ssg zrf
rsf: htj vkc
tfb: lkv
vbb: fdr skx
qxq: dbp dzr rcb
zpx: pcl kzx grm tmj
jcf: ghm ndm
czd: bsp ccr
htp: xtm vrn jhm
dpd: zcn ckh ghg zbp xjq
brf: lkq bqf zpj rzk
tsh: cqv
ndt: rcb
jlk: jrm
lzd: xbl
gmj: snf csz vgr
llc: cvh xcq lft
hlr: xxb ddn mff
cjn: gvx tgt lfz ljc
pnm: lpf ndr bnt zsk pvk dds
fmg: bmm klc hdz vpz
msj: vnc sqb
tpx: vdb vtj nmn nhf
qhm: sld kft
rrk: jfc hcj hsx hbg fpn
dnr: ngm mps
vtk: pbj
xqz: lbx ssf
nxz: llp vnr tfz
cpb: fdm tcj xhg
vnv: sst bcj lzh czp spj
hrd: sth mff dbz
cgp: mhm zmj rbq
hkz: sjx dbq zft kqk
lxc: gkj
bmj: rgp
dmc: gdt rvp xph txb ckg
tmb: pkd lhs
krm: hmm szh jmp
sst: khg sgv kpf
snz: njs bnx rcj kjr hbc zcb vbl
pfv: bbv qtk
znv: mjb tqt
xgf: bnc zng vqf dft
kdz: sld
ldb: plg
rss: rcb vlq rcx dpz
hrs: mnf xbl crp
lsl: tgs vtv fjr bgt
nqd: hrn mgs trm gkv
jhs: pgm xgh pjz xgb
hbn: kdt ljc bqf
scl: xgb hdz
xnd: lqr
vjn: hzk dxc dsm hjx
fjs: jfg jfv nmx btf qnh
qrb: mlk pmk
knz: rkg
ncm: sgv sxb
hqc: nzv vzs tqz
tfp: klf
scv: xgb lfl
jft: kmt lrd
nxs: pnc qfv hdn pnd qvb
sjv: pct
cck: mbz klp rlr rvc csr
sjp: ckf tsg
rbc: mch vsq nbp bkq
qtj: lnp dkn
lrb: hbp zgx
bxp: sdh kmf rxz
chz: vxk hrf mrb cxr qnh
mhf: fpn qxx vdb
zrv: bdm fnn
dlk: jjg dzx kjt
fvm: knm gpc
kjm: ppd cbk
rqx: czh
pdq: mhp dft dbk
fqg: sdt bsv
kqk: rgx mgk
lnp: nlc
tzm: jgg nts bmm jlj
qks: grj cst skg
qmt: vgh
shr: mfs
tqz: bqf srb
pgm: bgt jlf
njn: xvx zfj bpd
hpc: dxd qpr qbb ndr
fvk: tdn
rgx: vxk
gvj: ssl slr vpr pxf
czg: frd qdt
qvs: xvr mxg
cxz: mdc fgz
sck: kjk pdg qgp zjj zjp
mff: tkz kft
tpm: bsv
fnf: bcm xqz mbz shr mgt fzj xrm
ftf: dmd thk znk
vcp: ckq
ssk: jpm sjp rrv hlx tbb
hfc: mqv
xdv: jvl rvr vnc
bdq: ngr llc fzb
tqd: xcf trm rmr
vth: dcs tkl rmr zzk
knm: scv
xhg: ssg ksn
fxx: zvz vfz cft chr vbv zrd
bfm: zgd
ckh: xbv dnq jjb cnz
xcr: xqt
lvz: mlk xjq lfx vql
rtn: njj vqg zsk nmn ldb
qzc: vfz lrb nzv pbk
rsz: mdv
rqd: xmp cst mzz gxg jfr
gqn: rqk tpm
ghl: pgt
hch: dxc sbx
rbj: djb tpm flb
dbz: pgt
nfx: clv ptp ktz fbn
nnf: cns ndl
mxx: dzc
xrz: qdt
dfn: pjx xgr jrm
pqq: rvx
gdd: hmg nvs
tbb: xnd mnp jrk
csz: rhl
slb: txb dnj gnb
mgh: znq klf mqb jpv qgs hph
stq: fzd zzt ghr dsg
vjg: kvx
thq: gdf
str: qgs dps
grj: rpr fnx
mkk: dnq scv psg
nnx: ksx ttt xfp xlh qbl
qxz: xdc ggf
qrr: vpd czp
xnt: xll scl
lvl: dnj vqf qxq vmp qtb hqx
zkj: mxx tjp fkg rcx
rbh: nml zkf rkg kqj
gxl: rcc
mng: zmp tdg
cgm: hqc dxd nqn pdq
bcm: tkb
kls: vgh kql fzc
cpp: dkg nzt mkk ssg
rvx: jxn
hdm: kzj
kdl: shl cjg
szd: hbf bvv gzf mxx
cdv: qbf xdz snf mnl zzl
xgn: dbc gcn zmp vxz
ljk: vpr prj
cqb: nbz vhz gcn mnl
crj: hfb
bzj: srg ghd thh mmt
glq: vtv hlx cbs
vbl: jdb zgn
qcr: qlz
zpl: xtm rbm mbz fsn gsl
lbt: vvv pzk pqq
hqx: fzc
skq: hcn vfj bfb
crm: xgv fjv hks qkc rts mkb
fkk: bsq rzk nlh kmr
dcg: pnv rcm
ndl: kxr
pcl: lxb vzs jvx
ldq: lrp trh dgb ntb
hzj: scv ptn pmf qsr lpp
hjk: xqt
xcq: psp vll jzd
ddk: txv mdg
jbx: frk qpd jht kmp cgk rrn ngr grj
rqk: tmj
cbr: knz trm tfz czd
ckk: tpm rmq bvv
gcq: mzh lzb bgl qsl
ctc: hrn hdr mhb
lqv: rcc
srg: vlb cfg
jtm: psp zhn rdb kzv
gmr: jft lzh phj
pnt: jgl jds hvm
rdp: pnn vqg gzv rzx
mjd: trf rfn fbv
mgp: crp skx lbx rgp
lpf: lcn chl
zmg: xvj ffr
gcl: zfl prj
jgg: bfb
htv: xqz ngr rvd
vsg: gdf btv fcs
snf: sjm
ztg: mdr vgv rxd ddq
lsg: bcx lzd fpt
fzj: sjk vtk
crp: kdz
ddq: vrn zvl lqr
gjg: kzx trk qvs jzq
jqd: tfb ghq crj jbs
lnv: qtp bzr
rrn: hgm bhq
mll: bqc xtz rpv zbq
vrg: xtx
bkq: nqn btc
nmx: djb
mzx: ffr pls slm mqz
dzn: plz zrd ldb hdm qjx
zxt: pdf
tch: lnj jpv gft
hbt: sqq nzs dtx xqs mch
jqq: bfq hrs jlj khs
mqz: kjr xgv ghg
vqj: ldz nvf
vlx: hgm
bvj: xph sxf
zst: lkv dnb qgc sqc
ggx: srb jfd jmg lhj dcg
nmb: rcj
kqt: lcm fdd
kjk: rdt
rgm: xhn phx jjb rvx
mnp: bvg fdm
ljc: qjr
vzj: bdm bds gjm mkb dhz
jsc: lfl phz rdn tdn
szh: nvs
qsq: mps jrm cbk
smv: cfg ktc
vnr: sqq
bms: zlp
nzt: ssg gfz jbg
cfm: gnl jdb rlv qdv
bvg: tgs nbb
nbj: dbc cjn pdl xcf
dbh: pzk nts zfl
scj: vxg
xnx: ffr ngm qmh
hqk: qkt
ssm: vpd nbb
xlk: dzc
ccv: vhp xhg jrm
xnq: kxv rvd
vbm: pzk drk nmb ncn
dqh: gbq
tvv: dnv kfm xcx
ztn: cvk mzz jff
krn: jvx ndt cfz nbp
qgp: cql bzr qcr
jfg: tdg dtv
vlb: vnr
rdz: jkt jgg sfj
hpx: lkb lcn hvb jbl cqv
rcx: gqd
qmv: jbn kvx gzv
tsv: ggf tbg
zfz: scd rfn jhr
pjg: vbq thh bnc tjm
pdf: vjl pgg
tlg: hrn
fgc: dgc btc
fcp: nlj
mdj: vmb pct
bbd: jhr gsg jqs hbn
xvq: sbg
xpz: bgj
jmp: smk
tdv: cnj tfp
klc: phx ddn
vrz: fsb vfz chz qcp szt
mbg: rzh
mmt: lql
fsj: vjl
vxz: fjk
mxq: mbg
zjg: jlh ghq fsj npk
mnh: szv ltv gbq
stk: gct vfd crz nrg
skd: znq dxr dqc dtq
kbc: pqv mmt pgg zlh
vgv: hzm fzb
qgs: lql
pmf: nnp
ljd: lhs ghr mkv sdq tmb
ghg: ktz ndg
vzq: bpd jth
cgk: xcq kpq vbb
gkj: ftn
gbb: bqm fkg jrt htm
qbl: rqd nsm btx vkd zrv
nnl: tcj kpc qrr hch
cjq: gmx zgn
tdc: rvs dhz jlk gmq
gfs: xpf gjg zmp fsj tqz
vxj: msn hnb vvv zrv qmh
mlg: qrr hcm
sfl: hdn hjk vmk jdb
bzf: ksj nsq zrf drk
tsg: xmp nct kjr
crk: trk gbr pms
mkn: mlk zzg
slx: rfl vbl lnv
zjp: rhz
xqf: ccv qkc dbs
bbl: pmb jlz bkq skd
dzr: vxp
dzk: gtd lnp mps mzx
qgl: vxk
sjh: cgl scd tqd
vbv: tfp vnk
ssc: qgn qmh frm jsq
jrj: zml lbf zpt mgk
dbg: mkv gfp cvv lfz
tbg: drg
zzl: msj
dcq: qmt rbj mhs
nhx: hrs knm ntq mdc
ptv: rst dcq mtc nxz
kbj: crk hbg
thp: xjf rsh jvc nnf
ssl: hmj hgh
hvm: zhn jkl nlj
hcv: phz vdr mhm
xhq: scg vmb
mgx: jvx
flb: xgx
bxd: rlr cvh cdn
tlc: hrd lzh cjq kdj lnp xtj rmb
vbq: xhq hvb hpz
zbp: skq qtm
dsm: qlz
lcm: qdv vbt
frr: cln bsg
sld: lbx
frj: ldz dqb jpv fhp
msg: mhv ghl dlk clv
sjn: gxl hzh
rst: jgd gqd crj
vnl: dsm hcn ksx qcr
grv: xcf fsj vzc
lfd: ctc mch
jgq: fgz hgh ftl
ccg: zsd krj zxj gbm
znn: ptn vgk dkn qvg
fdv: tsd prj
szv: tll
vcb: rzx jvz mhb
gzb: mxr lxc
jdb: zzg jrm
zjd: pqv lqv hkm
crz: fqt
sdq: nbz lfd rnl
rgl: dbq ktd pfv zkv
khj: qmh
zjj: lht qcr
ntb: nct xxb
bsn: xck
bpd: jth
qsj: dkn xdc
tvg: kfm rqk
nsq: xvj mzh
qvg: kjm lzb
fgn: scl thq rvd jgl
jhx: krm rsf mxg vjm
sgc: xqt jjb zfl
kvm: pmf jsl bkr fjv
rdn: vnl
ngn: vtv
gpj: bgl rdb tdn
cft: zcl
xtz: pjx sth xxb
cjg: vfd dnf
pjq: hpz vrc pts mhp
fdn: htj zpp
bgs: rrt
zmh: rgx krj xjf
jth: dxb
fjl: jgd ltb vqg lrk dtq
zts: jrj sjh gct jmg grv
hsl: bqc
tvd: nts xng rhs
rhz: hdz bcx
kdj: jgl nmb
rxd: xlh vbm dsz
hzm: rfx
frd: jlk kxv
xdz: sdt ltb
pns: tll vgh
vpz: ptp ksx dmb
sdh: ssf ksm
xlh: lxj fpj
kqj: lbf gzb
btx: dbj bmm khg
chq: ktd qjt hhr pdl
dnq: fsx
nmf: sbr jgq ghg
kzv: qpd smx
mlp: qng llp txv
dpk: zfs dxb gvg
sjx: gft skk zzl
vxk: xgx
tgh: djb
shk: hqk mgh szv
tlf: txt qks bmj dkn rrt
ltv: kxr lxc
qbh: jmg
pqv: spm dtx
bdx: jgs tsv xrm dmb dbj
dpg: kgg rsf nxt
jcc: vds lch gfp thk
bjq: nmx cnj jqs rsh
cgv: dlq lqp tnx
srv: rmq cfl
sff: zcb clv
xzp: dbb nbc qrn ztn dkm
dzx: bzr rgp rpr gmq
lcn: pbk
hmb: spm ltb
pls: gdf
hsc: tzz brq vrg tdn
jpv: fdn
hgh: xpq kmp cfm nvv vrg
tmn: txt jbg mzh pxf
qnf: ffz slb mpb pqv
khb: kmp pjz lkr
fht: lpr fcz fdd
bcr: lrb jmp xcs
vlq: sqb fqt
drq: ccz fdn xvr rvr
jgs: bbr
txf: gdd mrb ghr
cbs: tzz
sjm: nfj
xdc: xhn fjr fsx
grx: tql
drg: qlz
vcg: cts jrt mrb
cxc: lrb hzh mst vlb
zcr: ppc gjm qsr ccb
mzz: fdm
cpg: mrb kxp zpp pqv
xpf: tqt
bjx: kxr pts
qdh: szh zgd vqj
zkf: mgk
fcc: pdg bcj
zlt: rhz grd kdj
sns: scv kgf
kmp: jkl zmg
szt: tfb xqs mrb
hxr: grx nvv zvl xtj
ghr: hdr
bbv: rpc zzk cqg
khs: bqc xnd hsl
zlp: hfb
gnn: khl bfm rtn fjq sdv
kmf: jkl fsx cbs
pdh: xll vgk cdn vtk
ffz: ldz vlb
lcp: zxj lnd zbr
qsp: vdr gfz gtr mlg
tpt: dqh gql skk spm nqn
jzd: xqt
hph: zft gnb
sdk: vsg ptp kjf ftl
dvc: zlp htm djb dbk
fdd: rzh
gpf: qzq bhq rmb dbh rrv
tht: pzh qdt tkt ckf
hsb: ssm gvn
pnv: tsh
rhb: sld khj ggf
jbc: chr mdg bxz xdv vkc
bqz: qkt qmv xgx
pjc: pnl zkv tqt
sxg: xnx tqx fcc gjm
mrv: vtt rzx znk dbc gmj
lcc: pjv vrn xnq zlt
prq: svb rzt jvz
rjd: thk pbk kmr xcx
xfp: phj sns hzz pjx
rgg: vql bdg bnx sld
zml: fvj tfp khl
jgd: jgz sbg zmp
lct: rxl bsc txf
hfl: gdl xbv
tsk: xgx dmd
rhx: bvv hxl
bnp: psg fbl qdv fsx
hzt: kvb zmg zkb xpb
rqz: mnp dzf zfj jgs
qpd: lbs
rcl: ksm
qff: hqt dhd vmp
mdr: gxg kjk ctj
qlj: xcr fdr gnl ptk
kgk: hgm jdb ctj
kvc: jht qlp vrn
lhx: mng zbr vjg vtx
cdn: cbf
xdb: kmf thq zmb
fzs: tsk zcl nfz ndr
dxc: ckq
vql: nts cbf
fdm: xbl
ktf: kjf frm xgh
jpt: lhb rpr
mhc: zfj pmk sdk zgj sbx
xjq: dbs kmf
ppm: ssf bxd zhn cgp
xxg: zbr rhc vdb
pbf: fpj drg shf
bds: cps dgb dxb
shp: bjx kxp bvj nnk
xqs: nlh
bvk: fqg gft vbv sdt
bzr: tsd
xcs: bsg txv txb
dqx: dtq pjc hpg kzk
dxr: fvh vzs rzb
pjz: zmj qfb xmp
dzb: lrq dkx ftl fzj
dbl: hfl cbf gdf crp
bfp: fpn rnl skk plg
qsl: xvx
rjj: mhm tmn mkx qvb
cts: nfj
bbb: scj sld
sqs: zng vnk fqt zkr flb
qjm: lcn zcl zcp tgl
pbj: ptk
ccb: dfn frm scv
fgq: vlb dps kbj ndt
sjg: scv lcm dlb btv
cqg: qtk
dhl: gdm fsj
phf: pnt dkm xqq zgn
zxq: kql frr dzc zsd
nzs: nfj xpf
bnc: mhs dpg
kmt: tsd
rmb: xgr mfs
gxp: tlg dhd
sgb: skx hlx
pgs: gvx vlb
qnl: nvf tvg mgs fhp xcx
mbz: lqr
mtj: ptk cbk
klp: vlx
cfz: xxg llp zkv
vhz: bms gkv vgr
fms: gkr
khl: kxp
lml: cqg jdh fjk nxt
dzf: sdh
xrt: xqf rsz mhm lrd
tql: dbj
qpr: pbk
zjr: qsz srv hdm mhp dcg
nfz: bsv gzv ftn
spj: sns dbj
zpt: hph
qfr: rrv slm vrg nsv
zmb: fvk
ctj: xrp
cfv: skf kmr rnk kdt
jpj: cbs chb ncn gmr rlv gmx
xsh: jcc cnj lfd lch lxp hqx
njs: jxn lkr fdr
cps: cjq fcs vbc
djv: xpb bmc
ptt: nvf gkj pgg
zzg: hcn
jzj: zcp ndm xlk bnc
fcs: dzf
jlg: xkr qnk cqv vfx
rnt: jzq lrb cnj nvf
sxr: zqn hsb rdn
xkk: rcl lzg vpr
fcz: ksm vlx kdz ghv
vgr: zpm jfd
mzq: vrn xcr
mzh: qfb
cxs: znk zcp nvk xjf
xxv: glg gvx mjb gbr
kjt: rzh zfj pgt
fjq: hqt bsc hqq qcp
gnz: kjm fcz vzq pzk
sxb: sgv pmk
svl: hsl xgb
lgx: xlk zsk qkt zst
lst: ftl djv xrm xrp dnr
ztx: jbl zpt tgt
hmm: rzb
kkf: jlh zzk nkv kfm
fnj: jbn dnv qjr
shx: bms rxl fjk
gfc: qjg zkf
pzh: nct
qfx: vgk cgv fqx mhv
fqf: vtv tsv rrn qlp
cjd: lxc
frk: spj dkg bmc
rrt: bcm
xbl: rlr
jdh: bfm scg gxl
ktd: mst cqv bxm
nqj: czh gdd lhs rmr
nxj: bxm hmg kqb xjc
rcp: tvg zlh ltv
xnz: fzb
hjx: hfc nlj
vmp: krj qbh
zvs: cps qhm lft sgb
skr: vjl xpz hmm krm fdc hfq
jvn: vxp nxg jns msv prq
ndm: rzk gdm
mpb: smk srb kmr
xsv: cbk jgg lnv rfx
nmh: qbh rhn ztf
pzk: fvk lqp rsz
rlv: vmk
ssg: dnk
shv: khb kjk shj gmm
bst: zzg dkn lft cnz
hxt: scv dgb rxz bxp
jvt: vgv rdt svl jpm bdg zgn
qfv: gpj xcr xbv pqq
zng: bms tmj
ksn: dkc hgm cql
vvx: plg tjp tfz
zpj: mnl nzv qbb dxk
rbq: svl
xrm: nlc tqx vcp
lft: cdn
lhb: rpr ksj mhv
gqs: rpv rrt dkc
vng: znk dzr pzr nml
dsg: nmx jmp spf
hdl: tvv kdl hmb mnh
hmg: tmj
bmc: rbq mlk
zsk: jbn
fgz: zhn zgj
phx: mdc
rhs: psp lzg lsl
mss: gvn bmj
tmq: rcp lcp vcb fnj rnt
vfj: fpt
svx: sdh nlb
zgn: tsd
dlq: rfs
jrt: qjg
dkm: jjg kvs
nzv: qcp zlp
btc: fzc
lpn: ghd vvx mgs mhp tch hpg zkr dft
nkv: tjp qgl
nvj: rcc
tnc: lrq hln qqq vgk dlb
kdm: dkg sth fvm fdv
xkr: dbp njz lvk
bhh: dsz dlb tkb
qmc: pmf bdm jht mss
hcj: kdt njj
bxz: jrh vmb
qtp: skx mbg
ghm: vjl
jvx: pzr
gjm: gtr fjv
mps: mcx
rhd: xgg lhj jdh qnh
htj: sjv
qrl: fdm xqn vpd mmx
sbx: sbr gmq
hbf: rnk str gkj
lnd: mrg gdd nvj
mpp: scv jpt tnx sth
jvl: pnn sxf
scd: znq kxp
rxl: bqm sjm mkv lhj
chd: qff zpt bzs npk
njd: nvj jfc gvx fpq sjn
mqj: qpr sjm tfb pzd cln
jvc: htj
gbm: bqz xpf hqq
sth: hks
xgg: rvr gkj hdm
mqr: ccr mdg lpf gzv
gkv: mnf fvh
jkd: jds phx nts
btf: rhx xqr rzk
vfh: gsg jbs xvq cfl
bdm: lrp sjk
rbm: jhm
lfx: gvn
zcb: msn
pmg: vvv jff ksm xzb
bnt: dcq qjx bxz
hmj: vbt dgb xnf
mhm: sbr xmn mqv tdn
pnp: hrq dmc lhs fzd
znr: szt jvl jgz
shf: gvg rgp
cnx: xpz gql jgz pfc
rcc: ddx
jzs: vmb plg dgc dzc
vnp: rbq zgj tzz
pkz: qhx jrk ptn zgn vfq lst
xzg: lzg ncm gsl rlv
dxh: pzd
lkx: fms bjm gct
mth: kmp kcg grd
hcm: dxc
tqm: vpr shf dlk dcv
chr: fkb blr
ztf: dqc
bpf: skq shr btt hmj
btv: tkz mbg qlz
qgc: vzs vfx ccr
pgg: jhr
qbf: nsp hhp vqf rzb bfp grm msv
clg: lqr czp rgp
bsc: dbk
rmk: hmg mxg flb vtj
psz: jnh vbc jkd
smx: cnz fdv
nqn: mnl
npm: jgg xnq
mqv: lrq
ffr: jxn
kzx: rqx kql vqg
kgf: lqr
ntq: tbg lfx mzz skg
qnt: rlr fjr
mbh: cst kqt tcj dbz
jvz: ccz
mkb: ggf xdc
sxn: rzt grm
zfs: bgl ljk
lqd: nkl xxm sqc jbl
vdr: xgr
hln: ssl vrg hzk
vxg: cvh dpc lfl pqq
nxt: lqv
blr: mgx jvc
shj: pdg mhv zmj
bsf: cjd tsh szh hqx
krt: gsl psp lzb
jfv: plg hbp
rfs: mdc
cdr: zxt str snf pqb
fpq: gxl tfz ffj lct
qjr: vlq pnn
tnt: xgv kxv prj xrz xnt
lnr: dcs fms bxm gzb
dnb: nmn xck fqg lcn
cfj: bms pgs qdh rzt
jjb: sld
hrp: nkc bnx zrf xll
slr: jlj hbc kdz
nnp: xnd sjk sth
hbg: vjg nxg
nsm: ppd rfs
tjm: cvv fcq
rzv: kmt lrq gcl npm
jdc: fkk zfz fvj mgh
kzk: pns qjg fsj
qfc: zfl
gvn: bvg dlq
xdd: fqg npk cjg
rdh: rnk tdv nfz
tzc: vjg ftf nkv jlh
lxb: sqb qjg
nkp: vsq scg hqq xjc
dbp: qkt dpz dgc
vqf: xsk
xgd: ztx kbj vxz
gfm: dsz khj lbx
kvg: rlr jth xqt gzd btt
tjz: sgb xnz vfj qhx
qvb: tkb kjr
kcg: jpt ggf fzj
gdr: zxt rmq ccj
jxv: rjd grm dnj csz hbt
fpv: jlk zmb lqp
xmn: pdh dmb
sqq: nlh fms
dbb: smx dnr tbg xzb
gcn: gfc jhr
mkx: cvk qsl
cfp: rdz qsj slm ngn
rts: mzq dbs sgk
pnc: lsg hpv ncn
csd: gnb ttr rdp
bxm: rcm qnh
fvx: zgx dtq rdh tgl
fjv: vpd
qlp: dnk
csr: grx jfr kpf ndv lbt
zbr: spm scd
nxl: xhg lft sjk
lhj: tlg
tdg: qnh cts jvx
txt: khj
hdq: fnx xqn lnp xrz sqk bdg
dbq: rsh bsv
nrk: gpc lbx zgc rvs jsm
kmk: kvx htm shl lpf
htm: sqb
glg: pns ckk svb hsx
vsq: xvq
mtc: sjv jvz djb hxl dxk
vtj: cln
qkn: mrg gkv mkv bmx
dmd: hbf kmr ghm
thh: srb kxr
dbs: tkt ssf
vxs: hpv rvd
snd: qjr glg dxh dps
jrh: cgl
ktz: pzk lrd
zpp: tmb zkv
rxz: bmm
xvm: mxq ndg xzg xgr
xhh: pnl fsb hqx
qqr: vsq hzh kjp ccr
dhd: zmp
vfq: svx nbb bdx
mst: pnv hcj
hlg: nmf jft xpq dnq
nlb: djv ngn
rmr: jfg
jff: ghl psz
cvv: jzq
gpc: nsm
jxn: dhz
jsl: zqn bgs jnh sfj
llp: mgk pbk
xqr: trk nmx jgr btc
mvd: gdr xdd qtb shk
zvl: nlc qnt klp
gdj: frd ptk lkr jhm rzh
hhm: jvx hbp mgh bjx zgd
lql: xpz
xfn: bgj pgs sxn xhh tgh znr
nkn: ngn bqd scv zjj
nnk: nhf rqx qvs
kqb: tgh
qjx: dbk tjm
fnn: jpj bhq
dbv: hdn mxq sgc glq
hrr: zzt pnl nvs skf
sfj: rpr
tkl: ghm dqc smk mrg bqz
cgl: nlh hrr
ckg: hbf
zcl: bgj
rkz: bfp htj lqv mhf dxd
qxd: kmk knz klf tjp
jkt: vmk hzm
dqp: spj scj vkd zjp
xcf: chl ldb
bmx: mhb zgx qmt
lgl: bfb
nsv: jds pdg
trm: vrc
srb: bsp vmb
gql: cqv
zrd: lql pnv
zkr: pfv qtb nmh qkt
gnb: tmj
fbl: sbr btt zcb rdb
kvb: skg ndg qkc
sgv: fbn
dtx: bsp
ndr: qgl
zcn: qfc
rnl: mqh ddx
ldm: zhn qhj jff xzg
lzb: dpc
rhr: qsq pgt xhn lzg
lrk: fzc rsh vzs
qsz: zcp
xhn: ptn
ngm: rfl tkb jbg ckf
zrx: jqs svb
tkz: tzz
rkg: skf
sbg: kfm dnf
czq: ldz sqs rqs frr
msn: cnz ckq
lqp: frm
kql: lcn
jnh: qdv ptk
bbr: dkc nts
ksc: ssm sxr dpk ppd
rxx: dpc tkz nmb mtj
vbc: mkn
jns: jrh nkl qhf
slm: kpf
dss: dxh pzr dnv xck
xsp: gxp lvk czh qbh
vfz: mgk zmh
shl: nfj ddx gcn
thk: qgl
dbc: mnf
bcj: hgm tkb
zkb: qfr xnd fpt kgf
rns: lss cjm rsz vhp
pxf: vmk
zfc: dnf chl ktc cft ndm
jtx: ksm dcv zcn tnx
lch: mnf fbv
gfv: lgl qfb hsb vfn
lkv: pkd lfz
hkm: mhp hrn
xdq: rdt sgk txt znm bhh
qtb: blr
ldz: rvr
fcq: vxp zrx dpz
tgl: fqt bsn
mnz: ttq jlf ndg qtj
rqs: ltv szv lnj pzj
vfx: pct rvp
tnl: hbn hpg bsn qxd tsk
xng: vtk qnt
dcl: hks fvk tdc btx
dkc: khg cbf
kxv: ppd xvj
vdk: plz sjv njz
dmk: xrp ncm qrb zcr ghg
fvh: vzs
ppc: sfj cvh
kvs: xzq dkg vbc bmj
hdn: rxz
qng: pgg hvb
gdm: vkg gbq
nbp: fvj bsc vkg dgc qng
phj: ljk nlj
gmv: xdc dkc fvm hlx
bdd: czg
sgk: dxc qtp
mxr: spf gql kjp
rmq: vds kgg zkv
jpm: fcp
fsn: bdd
pfc: hfq ddk
cfq: xhg tvj fsn pbf
rgz: gfp hkm rcm hhp ptt
hpg: ckp vkg
qjt: mqh smv dhl xcx
xgh: rvx mdv
ffj: jqs vjg zlx
tlp: lht bfq sgc hbc
mcf: drq tqt pzr qsz
dcs: jrh xph vnk mng lnd
lhr: vxs qvg krt hnb
fpj: xzq jjg qkc
bjm: dtv
cns: rnk gbr
ccj: cxc fqg tlg
lpp: jgl kjk lft
mhs: lfz sjv vfd
lvk: mhp
fzn: xnz bbk dcv lfl
gxg: xkk
nkf: vfn rsz mkn bbb
jmg: ccz
lkb: cqg drq gct xvr
gjf: hfl lzh nrq gvt
hhr: dft qpr fzd dzr vrc
kqc: pmf kzv cvk
pqb: vds ltv
fcx: tgh bsf hsx chd fbv
jfr: mbz jht
gqb: khg hcv nxl jtm
jfc: rhn kgg
crl: zbr xhq vsf czh
zvz: kjp cvv rhx
ksx: hzz
dpb: lqr xtj jds gdl
xgv: ncn
pnk: cxz tzz bgs pxf
qsr: fnx tgs bgs
dxt: fbv stk znk pvk
qdt: jkl
spf: nvj
ptd: fdd grx rdt sff
cql: bcj fbn
pmb: zrx fgc zzt bkq
lhf: bxz znv vfz kbj
hlx: fpt
hvc: njz gkv
phz: bgt vfn
lss: kft pbj dxb
gjd: crp dbz qfr bgl
trh: sxb lgl tsd
zzk: gfp nvs vtx
rfl: xtm
bzs: qgs gsg mjd vnr
dgp: vxs xtx jlj rfx gmx bpd
lpr: cpb dsz hcm
mkv: ftn
jgr: jqs lkq pqv
bsq: nlh lql
nsx: dsm gvg slx zqn
sqc: vjg fsb
shq: gft cnr dqb gvx
fkb: khl
rmg: kqj pqb trm
tpd: ttr vzs srg zlx
gfz: kvc jkt qxz qtm
mqg: vbc xnf kgk hjk
pdl: xph str
xvp: jxn kmt bpd fht
vds: rhl
nrg: dxr qtk vxz
znm: mhv mmx
xpq: jkt
dxd: kqb
hbp: shq
rpc: zxj vjm btc rzb crz
dhz: zbq
tcj: xnz rpv
bgt: tqx
gsg: chl jbl
cjm: zbq xtx rhb
qnk: xqs vxp jcc
qbq: cfg rqk gbr xdz
hqq: hqk kqb
nks: qjx scg jbl fkb msv
clv: gmq
jzn: khs gfz qsr kjk
qtm: ndg
dkn: drg xnf
qhj: zgj bqd xqn dsm
rfn: rgx
nbq: zrd jvc trf hdr
zfl: mdc
tgt: ddx
dtv: jgz mjd smv
mlk: jgl
vkg: jlh
lnt: hlr frk ddn hks
gtd: ptp dlk dpc
ghv: chb qtm gmx
qgj: mdv qlp bcx qsl
bcx: hcn
bzx: gqs mss fbn dxb clg
mqb: hph tfp lbf
fqx: lht vbt bqd
trt: knz mdg crz bvv
hhp: xjf pjc
kpq: vzq xnt xvj qtj
jpl: qxz ngr qnt cbf jkd xdb
zfj: fcc
vkd: skq xmn
pnx: ztf sxf kzj pvk
kzj: zzt vgh
xrp: jkl
nkc: xpq ppc vvv rdn
vzc: njj zgd cqv
skg: dmb jzd
dkx: ctj pzh
ttr: srb kzj
xvt: rcm dbq kdl ckg
gzf: dmd hzh ckg
pct: dds gkr
ktc: csz vkc ghq
dcv: gvg hfl
xmp: lkr
zfh: sdt gqn hdr gkr zzl
pxb: nbb fcc gcl dkx
lrz: kgg xgd hmb mxg spf
zsd: fms cln
zgx: zft dnj
ddn: lrp
mkq: nzt fnn nbc htv
qqq: scj sgv lgl
nml: cft smk rzt
xpb: xtm bcj
mjb: hpz
bdp: fcs mth mlg cfp
kcc: czp vnp dcv gpc
hxl: qjg rcc
vtt: dhl gfc pzj
bfq: vll cxz rvs
vcq: xnf kqc frd dpb
gnp: qsj mmx qpd vfj zqn
gvt: pkn rfx ndv
bmr: nsm lnv npm
jbs: nqn dds
gqd: std
nmn: txv
kkm: htp vbb svx mmx
vtq: jzq bsn crk pqv
krj: mdj
ntl: lzg hfc qzq vlx psz
rnk: hxl
